SIZE MAP 11X15
MAX PLAYERS 30
BEST SCORE 0
WWWWWWWWWWWWWWW
WFFFFBBBBBFFF2W
WFWWWWWFWWWWWFW
WFWFBFFFFBFBWFW
WFWFBFFWFBBBWFW
WBFFBFWWWFBBBFW
WBWFBBFWBFFFWFW
WBWFBBFBBFFFWBW
WFWWWWWFWWWWWFW
W1FFFFBBBBBBFFW
WWWWWWWWWWWWWWW
