SIZE MAP 11X15
MAX PLAYERS 30
BEST SCORE 0
WWWWWWWWWWWWWWW
WFFFFFFFFFFFFFW
WFFFFBBBBBFFFFW
WFFFFBBBBBFFFFW
WFFFFBBBBBFFFFW
WFFBBBBBBBBBFFW
WFFFFBBBBBFFFFW
WFFFFBBBBBFFFFW
WFFFFBBBBBFFFFW
WFFFFFFFFFFFFFW
WWWWWWWWWWWWWWW
