SIZE MAP 11X15
MAX PLAYERS 30
BEST SCORE 0
WWWWWWWWWWWWWWW
WFFFFFFFFFFFF2W
WFFFFBBBBBFFFFW
WFFFFBBBBBFFFFW
WFFFFBBBBBFFFFW
WFFBBBBBBBBBFFW
WFFFFBBBBBFFFFW
WFFFFBBBBBFFFFW
WFFFFBBBBBFFFFW
W1FFFFFFFFFFFFW
WWWWWWWWWWWWWWW
