SIZE MAP 11X15
MAX PLAYERS 30
BEST SCORE 0
WWWWWWWWWWWWWWW
WWWFWFWFWFWFWFW
WFFBBBBBBBBBFFW
WFWBWBWBWBWBWFW
WFFBBBBBBBBBFFW
WFWBWBWBWBWBWFW
WFFBBBBBBBBBFFW
WFWBWBWBWBWBWFW
WFFBBBBBBBBBFFW
WFWFWFWFWFWFW1W
WWWWWWWWWWWWWWW
