SIZE MAP 11X15
MAX PLAYERS 30
BEST SCORE 0
WWWWWWWWWWWWWWW
W2WFWFWFWFWFWFW
WFFBBBBBBBBBFFW
WFWBWBWBWBWBWFW
WFFBBBBBBBBBFFW
WFWBWBWBWBWBWFW
WFFBBBBBBBBBFFW
WFWBWBWBWBWBWFW
WFFBBBBBBBBBFFW
WFWFWFWFWFWFW1W
WWWWWWWWWWWWWWW
