SIZE MAP 22X15
MAX PLAYERS 30
BEST SCORE 0
WWWWWWWWWWWWWWW
WFFFFFFFBBFFFFW
WFFWFFFFWWWWFFW
WFFWFBFFWFFWFFW
WFFWFBFFWWWWFFW
WBBWFBBBWBBFFFW
WBFWFFFBWFBBFFW
WBBWFFFFWFFFFFW
WFFWWWWFWFBFFFW
WFFFBFBFFBBFFFW
W1FFBBBBBFBFF2W
WFFFBBBBBFBBFFW
WFFFBFBFBBBFFFW
WFBWWWFBFWWWFFW
WFWFFFWFWFFFWFW
WFBWFFFWFFFWFFW
WFFBWFFFFFWFFFW
WFBBFWFFFWBBFFW
WFFFFFWFWBBBFFW
WFBBBBFWFBBFFFW
WFFFFFBBBFBFFFW
WWWWWWWWWWWWWWW
