SIZE MAP 11X30
MAX PLAYERS 30
BEST SCORE 0
WWWWWWWWWWWWWWW
WFFFFFIFFFFFFFW
WFFBFFFFBBBBFFW
WFFBFFFFBFFBFFW
WFFBFFFFBBBBFFW
WFFBFFFFBFFFFFW
WFFBFFFFBFFFFFW
WFFBFFFFBFFFFFW
WFFBBBBFBFFFFFW
WFFFFFFIFFFFFFW
W1FFFFFFFFFFF2W
WFFFFFFFFFFFFFW
WFFFFFIFFFFFFFW
WFFBFFFFBBBBFFW
WFFBFFFFBFFBFFW
WFFBFFFFBBBBFFW
WFFBFFFFBFFFFFW
WFFBFFFFBFFFFFW
WFFBFFFFBFFFFFW
WFFBBBBFBFFFFFW
WFFFFFFIFFFFFFW
WWWWWWWWWWWWWWW
