SIZE MAP 22X15
MAX PLAYERS 30
BEST SCORE 0
WWWWWWWWWWWWWWW
WFFFFFFFFFFFFFW
WFFBFFFFBBBBFFW
WFFBFFFFBFFBFFW
WFFBFFFFBBBBFFW
WFFBFFFFBFFFFFW
WFFBFFFFBFFFFFW
WFFBFFFFBFFFFFW
WFFBBBBFBFFFFFW
WFFFFFFFFFFFFFW
W1FFFFFFFFFFF2W
WFFFFFFFFFFFFFW
WFFFFFFFFFFFFFW
WFFBBBFFFBBBFFW
WFBFFFBFBFFFBFW
WFFBFFFBFFFBFFW
WFFFBFFFFFBFFFW
WFFFFBFFFBFFFFW
WFFFFFBFBFFFFFW
WFFFFFFBFFFFFFW
WFFFFFFFFFFFFFW
WWWWWWWWWWWWWWW
