SIZE MAP 11X15
MAX PLAYERS 6
BEST SCORE 0
WWWWWWWWWWWWWWW
WBBBFFFBBBFFFFW
WFBBBFFFBFBBFFW
WFFFFBFFFFFFFFW
WFBFWWWWWWWFFFW
WBFBW1FFF2WBBBW
WFFFWFWWWFWFFFW
WBFBBFFBFFBBFFW
WFFFFFFBFFFFFFW
WFFFBBBBBFBFFFW
WWWWWWWWWWWWWWW
