SIZE MAP 11X15
MAX PLAYERS 6
BEST SCORE 0
WWWWWWWWWWWWWWW
WBBBFFFBBBFFFFW
WFBBBFFFBFBBFFW
WFFFFBFFFFFFFFW
WFBFFBBBFBFFFFW
WFFFFF12FFBBBBW
WFFFFBBFFFFFFFW
WBFBBFBFFBBBFFW
WFFFFBBFFFFFFFW
WFFFBBBBBFBFFFW
WWWWWWWWWWWWWWW
