SIZE MAP 11X15
MAX PLAYERS 30
BEST SCORE 0
WWWWWWWWWWWWWWW
WFFFFFIFFFFFFFW
WFFBFFFFBBBBFFW
WFFBFFFFBFFBFFW
WFFBFFFFBBBBFFW
W1FBFFFFBFFFF2W
WFFBFFFFBFFFFFW
WFFBFFFFBFFFFFW
WFFBBBBFBFFFFFW
WFFFFFFIFFFFFFW
WWWWWWWWWWWWWWW
