SIZE MAP 11X15
MAX PLAYERS 4
BEST SCORE 0
WWWWWWWWWWWWWWW
WBFFFFIFFFFFFBW
WFFCFFFFCCCCFFW
WFFCFBFFCFFCFFW
WFFCFFFFCCCCFFW
W1FCFFFFCFFBF2W
WFFCFFFFCFFFFFW
WFFCFBFFCFFFFFW
WFFCCCCFCFFFFFW
WFFFBFFIFFBFFFW
WWWWWWWWWWWWWWW
