SIZE MAP 11X15
MAX PLAYERS 30
BEST SCORE 0
WWWWWWWWWWWWWWW
WFFFFFFFFFFFFFW
WFFBBFFFFFBBFFW
WFFFBBFFFBBFFFW
WFFFFBBBBBFFFFW
W1FFFBBBBBFFF2W
WFFFFBBBBBFFFFW
WFFFBBFFFBBFFFW
WFFBBFFFFFBBFFW
WFFFFFFFFFFFFFW
WWWWWWWWWWWWWWW
