SIZE MAP 15X11
MAX PLAYERS 6
BEST SCORE 0
WWWWWWWWWWWWWWW
WIFFFFFFFFFFFIW
WFFCCFFFFFCCFFW
WFFFCCFBFCCFFFW
WFFFFCCCCCFFFFW
W1FFBCCBCCBFF2W
WFFFFCCCCCFFFFW
WFFFCCFBFCCFFFW
WFFCCFFFFFCCFFW
WIFFFFFFFFFFFIW
WWWWWWWWWWWWWWW
