SIZE MAP 11X15
MAX PLAYERS 30
BEST SCORE 0
WWWWWWWWWWWWWWW
WFFFFFFFFFFFFFW
WFFBBFFWFFBBFFW
WFFFBBFWFBBFFFW
WWWFFBBBBBFFWWW
W1FFFBFWFBFFF2W
WWWFFBBBBBFFWWW
WFFFBBFWFBBFFFW
WFFBBFFWFFBBFFW
WFFFFFFFFFFFFFW
WWWWWWWWWWWWWWW
